00000000000000000000000000000000
00000000000000600000000000000000
00000000000000000000000000000000
00000000000000120000000000000000
00000000000000020345034500120000
00000000000000020000000000020000
00000000000000020000000000020000
00000000000000020000000000010000
00000000000000020000000000000000
00000000000001110000000000000000
00003450034500110000000000000060
02100000000000110000000000000000
02000000000000110000000011101110
02000000000000110003450000000000
02000000000600110000000000000000
34534501110000110000000000000000
00000000000120110000000000000000
00000000000020111001112000000000
00000000000020110000002000000000
00000000000020110000002000000060
00000000000020110000002000000000
11100034500345110000001001100111
00000000000000000000000000000000
00000000000000000000000000000000