00000000000000000000000000000000
00000000000000000000000000000000
00000000000000000000000000000000
00000000000000000000000000000000
00000000000000000000000000000000
00000000000000000000000000000000
00000000000000000000000000000000
60000000000000000000000000000000
11200000000000006000000000000000
00200000000000000000345345001120
00200000000111100000000000000020
00200000000000000000000000000020
00111110000000000000000000000020
00000000000000000000000006000020
00000000000000000000000000000010
00000000000000000000210034500100
00000000000000000000200000000000
00000000000000000000200000000000
00000000000000000000200000000006
00000000000000000000200000000000
00000000000000000000200000000000
11100111001111111111110011100111
00000000000000000000000000000000
00000000000000000000000000000000