00000000000000000000000000000000
00000000000000000000000000000000
00000000000000000000000000000000
60000000000000000000000000000000
00000000000000000000000000000000
34534500000600000000000000000000
00000001103450034501200000000000
00000000000000000000200000000000
00000000000000000000206000000000
00000000000000000000345000000000
00000000000000000000000000345120
00000000000000000000000000000020
00000000000000000000000000000020
00000000000000000000000000000020
00000000000000000000000000000020
00000000000000000000000000000020
00000000000000000000000060000020
00000000000000000000000000111110
00000000000000000000011000000000
00000000000000001100000000000000
11111111110011000000000000000000
11111111110000000000000000000000
00000000000000000000000000000000
00000000000000000000000000000000